17,17
WWWWWWWWWWWWWWWWW
W1CCCCCCCCCCCCC2W
WEWCWCWCWCWCWCWEW
WCCCCCCCCCCCCCCCW
WCWCWCWCWCWCWCWCW
WCCCCCCCCCCCCCCCW
WCWCWCWCWCWCWCWCW
WCCCCCCCCCCCCCCCW
WCWCWCWCWCWCWCWCW
WCCCCCCCCCCCCCCCW
WCWCWCWCWCWCWCWCW
WCCCCCCCCCCCCCCCW
WCWCWCWCWCWCWCWCW
WCCCCCCCCCCCCCCCW
WEWCWCWCWCWCWCWEW
W3CCCCCCCCCCCCC4W
WWWWWWWWWWWWWWWWW